{
  "name": "level1",
  "player": { "x": 8, "y": 1 },
  "map": [
    [2,2,2,2,2,2,2,2,2,2,2,2,2,2,2,2],
    [2,1,1,1,1,1,1,1,1,1,1,1,1,1,1,2],
    [2,1,1,1,2,2,1,1,1,2,2,1,1,1,1,2],
    [2,1,3,1,1,1,1,2,1,1,1,1,3,1,1,2],
    [2,1,1,1,1,2,1,1,1,1,2,1,1,1,1,2],
    [2,1,1,2,1,1,1,1,1,1,1,2,1,1,1,2],
    [2,1,1,1,1,1,2,2,2,1,1,1,1,1,1,2],
    [2,1,1,1,3,1,1,1,1,1,3,1,1,1,1,2],
    [2,1,2,1,1,1,1,1,1,1,1,1,2,1,1,2],
    [2,1,1,1,1,1,1,2,1,1,1,1,1,1,1,2],
    [2,1,1,1,1,2,1,1,1,2,1,1,1,1,1,2],
    [2,1,1,1,1,1,1,1,1,1,1,1,1,1,1,2],
    [2,1,1,1,1,1,1,1,1,1,1,1,1,1,1,2],
    [2,1,1,1,1,1,1,1,1,1,1,1,1,1,1,2],
    [2,1,1,1,1,1,1,1,1,1,1,1,1,1,1,2],
    [2,2,2,2,2,2,2,2,2,2,2,2,2,2,2,2]
  ]
}
